던전 ID,던전 타입,입장권 아이템 ID,해금 조건 스테이지,이전 던전 스테이지
ID,dungeonType,ItemID,stageID01,stageID02
int,enum,int,int,int
6110001,,,,
6110002,,,,
6110003,,,,
6110004,,,,
6110005,,,,
6110006,,,,
6110007,,,,
6110008,,,,
6110009,,,,
6110010,,,,
6110011,,,,
6110012,,,,
6110013,,,,
6110014,,,,
6110015,,,,
6110016,,,,
6110017,,,,